#@........#
#.........#
###.......#
..##......#
...###....#
....###...#
....
.
.
.
.